XXXXXXXXXXXXXXXXXX  XXXXXXXXXXXXXXXXXXXXX  XXXXXXXXXXXXXXXXXXXXXXXXX
XXXXXXXXXXXXXXXXXX  XXXXXXXXXXXXXXXXXXXXX  XXXXXXXXXXXXXXXXXXXXXXXXX
XXXXXXXXXXXXXXXXXX  XXXXXXXXXXXXXXXXXXXXX  XXXXXXXXXXXXXXXXXXXXXXXXX
XXXXXXXXXXXXXXXXXX  XXXXXXXXXXXXXXXXXXXxx  XXXXXXXXXXXXXXXXXXXXXXXXX
D                                                                   
                                                                    
XXXXXXXXp XXXXXXXX  XXXXXXXXXX  XXXXXXXXX  XXXXXXXXXX  XXXXXXXXXXXXX
XXXXXXXX  XXXXXXXX  XXXXXXXXXX  XXXXXXXXX  XXXXXXXXXX  XXXXXXXXXXXXX
XXXXXXXX  XXXXXXXX  XXXXXXXXXXe XXXXXXXXX  XXXXXXXXXX  XXXXXXXXXXXXX
XXXXXXXX  XXXXXXXX  XXXXXXXXXXXXXXXXXXXXX  XXXXXXXXXX  XXXXXXXXXXXXX
XXXXXXXX  XXXXXXXX  XXXXXXXXXXXXXXXXXXXXX   B          XXXXXXXXXXXXX
XXXXXXXX  XXXXXXXX  XXXXXXXXXXXXXXXXXXXXX             dXXXXXXXXXXXXX
XXXXXXXX  XXXXXXXX  XXXXXXXXXXXXXXXXXXXXX  XXXXXXXXXXXXXXXXXXXXXXXXX
XXXXXXXX  XXXXXXXX  XXXXXXXXXXXXXXXXXXXXX  XXXXXXXXXXXXXXXXXXXXXXXXX
XXXXXXXX  XXXXXXXX  XXXXXXXXXXXXXXXXXXXXX  XXXXXXXXXXXXXXXXXXXXXXXXX
E                                                                  P
                                                                    
XXXXXXXXXXXXXXXXXX  XXXXXXXXXX  XXXXXXXXX  XXXXXXXXXXXXXXXXXXXXXXXXX
XXXXXXXXXXXXXXXXXX  XXXXXXXXXXv XXXXXXXXX  XXXXXXXXXXXXXXXXXXXXXXXXX
XXXXXXXXXXXXXXXXXX  XXXXXXXXXXXXXXXXXXXXXV XXXXXXXXXXXXXXXXXXXXXXXXX
XXXXXXXXXXXXXXXXXX  XXXXXXXXXXXXXXXXXXXXX  XXXXXXXXXXXXXXXXXXXXXXXXX